0000000000000000000000000000000000000000000000000000000000000000000000000000000000000000000000000000
0000000000000000000000000000000000000000000000000000000000000000000000000000000000000000000000000000
0000000000000000000000000000000000000000000000000010000000000000000000000000000000000000000000000000
0000000000000000000000000000000000000000000000000110000000000000000000000000000000000000000000000000
0000000000000000000000000000000000000000000000000111000000000000000000000000000000000000000000000000
0000000000000000000000000000000000000000000000000111000000000000000000000000000000000000000000000000
0000000000000000000000000000000000000000000000001101000000000000000000000000000000000000000000000000
0000000000000000000000000000000000000000000000001101100000000000000000000000000000000000000000000000
0000000000000000000000000000000000000000000000001001100000000000000000000000000000000000000000000000
0000000000000000000000000000000000000000000000011000100000000000000000000000000000000000000000000000
0000000000000000000000000000000000000000000000011000110000000000000000000000000000000000000000000000
0000000000000000000000000000000000000000000000010000110000000000000000000000000000000000000000000000
0000000000000000000000000000000000000000000000110000010000000000000000000000000000000000000000000000
0000000000000000000000000000000000000000000000110000011000000000000000000000000000000000000000000000
0000000000000000000000000000000000000000000000100000011000000000000000000000000000000000000000000000
0000000000000000000000000000000000000000000001100000001000000000000000000000000000000000000000000000
0000000000000000000000000000000000000000000001100000001100000000000000000000000000000000000000000000
0000000000000000000000000000000000000000000001000000001100000000000000000000000000000000000000000000
0000000000000000000000000000000000000000000011000000000100000000000000000000000000000000000000000000
0000000000000000000000000000000000000000000011000000000110000000000000000000000000000000000000000000
0000000000000000000000000000000000000000000010000000000110000000000000000000000000000000000000000000
0000000000000000000000000000000000000000000110000000000010000000000000000000000000000000000000000000
0000000000000000000000000000000000000000000110000000000010000000000000000000000000000000000000000000
0000000000000000000000000000000000000000000100000000000011000000000000000000000000000000000000000000
0000000000000000000000000000000000000000000100000000000001000000000000000000000000000000000000000000
0000000000000000000000000000000000000000001100000000000001000000000000000000000000000000000000000000
0000000000000000000000000000000000000000001000000000000001100000000000000000000000000000000000000000
0000000000000000000000000000000000000000001000000000000001100000000000000000000000000000000000000000
0000000000000000000000000000000000000000011000000000000000100000000000000000000000000000000000000000
0000000000000000000000000000000000000000011000000000000000110000000000000000000000000000000000000000
0000000000000000000000000000000000000000010000000000000000110000000000000000000000000000000000000000
0000000000000000000000000000000000000000110000000000000000010000000000000000000000000000000000000000
0000000000000000000000000000000000000000110000000000000000011000000000000000000000000000000000000000
0000000000000000000000000000000000000000100000000000000000011000000000000000000000000000000000000000
0000000000000000000000000000000000000001100000000000000000001000000000000000000000000000000000000000
0000000000000000000000000000000000000001100000000000000000001100000000000000000000000000000000000000
0000000000000000000000000000000000000001000000000000000000001100000000000000000000000000000000000000
0000000000000000000000000000000000000011000000000000000000000100000000000000000000000000000000000000
0111111111111111111111111111111111111111000000000000000000000111111111111111111111111111111111111111
0011100000000000000000000000000000000000000000000000000000000000000000000000000000000000000000000010
0000110000000000000000000000000000000000000000000000000000000000000000000000000000000000000000001100
0000011000000000000000000000000000000000000000000000000000000000000000000000000000000000000000010000
0000001110000000000000000000000000000000000000000000000000000000000000000000000000000000000001100000
0000000011000000000000000000000000000000000000000000000000000000000000000000000000000000001110000000
0000000001110000000000000000000000000000000000000000000000000000000000000000000000000000011100000000
0000000000111000000000000000000000000000000000000000000000000000000000000000000000000000110000000000
0000000000001100000000000000000000000000000000000000000000000000000000000000000000000011100000000000
0000000000000111000000000000000000000000000000000000000000000000000000000000000000000110000000000000
0000000000000011100000000000000000000000000000000000000000000000000000000000000000001100000000000000
0000000000000000110000000000000000000000000000000000000000000000000000000000000000111000000000000000
0000000000000000011100000000000000000000000000000000000000000000000000000000000001100000000000000000
0000000000000000000110000000000000000000000000000000000000000000000000000000000111000000000000000000
0000000000000000000011100000000000000000000000000000000000000000000000000000001110000000000000000000
0000000000000000000001110000000000000000000000000000000000000000000000000000011000000000000000000000
0000000000000000000000011000000000000000000000000000000000000000000000000001110000000000000000000000
0000000000000000000000001110000000000000000000000000000000000000000000000011100000000000000000000000
0000000000000000000000000011000000000000000000000000000000000000000000000110000000000000000000000000
0000000000000000000000000001100000000000000000000000000000000000000000011100000000000000000000000000
0000000000000000000000000000011000000000000000000000000000000000000000110000000000000000000000000000
0000000000000000000000000000001100000000000000000000000000000000000011100000000000000000000000000000
0000000000000000000000000000000100000000000000000000000000000000000011000000000000000000000000000000
0000000000000000000000000000000100000000000000000000000000000000000001000000000000000000000000000000
0000000000000000000000000000001100000000000000000000000000000000000001000000000000000000000000000000
0000000000000000000000000000001000000000000000000000000000000000000001100000000000000000000000000000
0000000000000000000000000000001000000000000000000000000000000000000000100000000000000000000000000000
0000000000000000000000000000011000000000000000000000000000000000000000100000000000000000000000000000
0000000000000000000000000000010000000000000000000000000000000000000000110000000000000000000000000000
0000000000000000000000000000010000000000000000000000000000000000000000010000000000000000000000000000
0000000000000000000000000000110000000000000000000000000000000000000000010000000000000000000000000000
0000000000000000000000000000100000000000000000000000000000000000000000011000000000000000000000000000
0000000000000000000000000000100000000000000000000000000000000000000000011000000000000000000000000000
0000000000000000000000000001100000000000000000000000000000000000000000001000000000000000000000000000
0000000000000000000000000001100000000000000000000000000000000000000000001100000000000000000000000000
0000000000000000000000000001000000000000000000000000000000000000000000001100000000000000000000000000
0000000000000000000000000011000000000000000000001111000000000000000000000100000000000000000000000000
0000000000000000000000000011000000000000000000111000100000000000000000000110000000000000000000000000
0000000000000000000000000010000000000000000001110000010000000000000000000110000000000000000000000000
0000000000000000000000000110000000000000000011000000001110000000000000000010000000000000000000000000
0000000000000000000000000110000000000000000110000000000011000000000000000011000000000000000000000000
0000000000000000000000000100000000000000011000000000000001110000000000000011000000000000000000000000
0000000000000000000000001100000000000000110000000000000000111000000000000001000000000000000000000000
0000000000000000000000001100000000000011100000000000000000001100000000000001100000000000000000000000
0000000000000000000000001000000000000111000000000000000000000111000000000001100000000000000000000000
0000000000000000000000011000000000001100000000000000000000000001100000000000100000000000000000000000
0000000000000000000000011000000000111000000000000000000000000000111000000000110000000000000000000000
0000000000000000000000010000000001100000000000000000000000000000011100000000110000000000000000000000
0000000000000000000000110000000111000000000000000000000000000000000110000000010000000000000000000000
0000000000000000000000110000001110000000000000000000000000000000000011100000011000000000000000000000
0000000000000000000000100000011000000000000000000000000000000000000001110000011000000000000000000000
0000000000000000000001100001110000000000000000000000000000000000000000011000001000000000000000000000
0000000000000000000001100011100000000000000000000000000000000000000000001110001000000000000000000000
0000000000000000000001000110000000000000000000000000000000000000000000000111001100000000000000000000
0000000000000000000001011100000000000000000000000000000000000000000000000001110100000000000000000000
0000000000000000000011110000000000000000000000000000000000000000000000000000111100000000000000000000
0000000000000000000011100000000000000000000000000000000000000000000000000000001110000000000000000000
0000000000000000000010000000000000000000000000000000000000000000000000000000000110000000000000000000
0000000000000000000000000000000000000000000000000000000000000000000000000000000000000000000000000000
0000000000000000000000000000000000000000000000000000000000000000000000000000000000000000000000000000
0000000000000000000000000000000000000000000000000000000000000000000000000000000000000000000000000000
0000000000000000000000000000000000000000000000000000000000000000000000000000000000000000000000000000
